#Scandinavia
NSJ = "countries/Nordsjoen.txt"

#Balkans
LTN = "countries/Rhomaniae.txt"
NIC = "countries/Nicaea.txt"
#Colonies
VNL = "countries/Vinland.txt"

#Eastern Europe
MSK = "countries/Minsk.txt"
PRT = "countries/Pruthenia.txt"
GRP = "countries/GreaterPoland.txt"
LRP = "countries/LesserPoland.txt"
HLY = "countries/Halych.txt"
VLH = "countries/Volhynia.txt"
NOA = "countries/NovaAnglia.txt"
GZO = "countries/GazarianOrder.txt"
SRK = "countries/Sarkel.txt"
TMU = "countries/Tmutarakan.txt"
VLC = "countries/Vlachs.txt"
JSZ = "countries/Jasz.txt"

#Baltic
SKL = "countries/Skalvia.txt"
PMS = "countries/Pomesania.txt"
GLI = "countries/Galindia.txt"
YOT = "countries/Yotvingia.txt"
SMG = "countries/Samogitia.txt"
WRM = "countries/Warmia.txt"
LNI = "countries/Selonia.txt"
SGL = "countries/Semigalia.txt"
LTG = "countries/Latgalia.txt"
REV = "countries/Revala.txt"
SRE = "countries/Saaremaa.txt"
SAA = "countries/Sakala.txt"
UGA = "countries/Ugandi.txt"
VRU = "countries/Virumaa.txt"

#France
ANJ = "countries/Anjou.txt"
PTU = "countries/Poitou.txt"
KOA = "countries/Arles.txt"
LYO = "countries/Lyon.txt"
FCC = "countries/FrancheComte.txt"
MPO = "countries/Forcalquier.txt"
AQI = "countries/Aquitaine.txt"

#HRE
CTH = "countries/Carinthia.txt"
CNO = "countries/Carniola.txt"
CRR = "countries/Chur.txt"
ZRC = "countries/Zurich.txt"

#Spain
TLD = "countries/Toledo.txt"
LAR = "countries/Baleares.txt"

#Italy
ANC = "countries/Ancona.txt"
VRA = "countries/Verona.txt"
LTI = "countries/Lutici.txt"

#Low Countries

#Russia
MRM = "countries/Murom.txt"
PRL = "countries/Pereyaslavl.txt"
KAI = "countries/Kasimov.txt"
CUM = "countries/Cumans.txt"
VLB = "countries/Volga_Bulgaria.txt"
VLA = "countries/Vladimir.txt"
GRR = "countries/GreatRus.txt"
SVR = "countries/Severia.txt"
KSK = "countries/Kursk.txt"
TPT = "countries/Toropets.txt"
DNR = "countries/DonRepublic.txt"
TAM = "countries/Tambov.txt"

#Arabia
ZNG = "countries/Zangids.txt"

#Asia Minor
LAM = "countries/Lesser_Armenia.txt"
CAH = "countries/Antioch.txt"
CTP = "countries/CrusaderTripoli.txt"
ERZ = "countries/Erzincan.txt"
EZU = "countries/Erzurum.txt"

#Maghreb
ABS = "countries/Abbasids.txt"
AYY = "countries/Ayyubids.txt"
MRN = "countries/Marinid.txt"
ALX = "countries/Alexandria.txt"
BGH = "countries/BanuGhaniya.txt"

#Central Asia
QRA = "countries/Qara_Khitai.txt"
KIP = "countries/Kipchaks.txt"
QCH = "countries/Qocho.txt"
YNK = "countries/Yenisei_Kyrgyz.txt"
TRK = "countries/TurkicKhaganate.txt"
UYG = "countries/Uyghurs.txt"
KIM = "countries/Kimek.txt"
QRK = "countries/KaraKhanids.txt"
TGK = "countries/TsagaanKhitai.txt"
QRL = "countries/Qarluks.txt"

#Persia
KWM = "countries/Khwarezm.txt"
SLJ = "countries/Seljuks.txt"
ALN = "countries/Alania.txt"
ASY = "countries/Assyria.txt"
AHL = "countries/Ahlat.txt"

#Americas

#Africa
ZIB = "countries/Zimbabwe.txt"
IFA = "countries/Ifat.txt"
DHK = "countries/Dahlak.txt"
SSO = "countries/Sosso.txt"
GNA = "countries/Ghana.txt"

#Mongols
TMD = "countries/Tumed.txt"
BAY = "countries/Bayad.txt"
BGG = "countries/Barga.txt"
KMG = "countries/Khamag.txt"
QGR = "countries/Qongirat.txt"
TTR = "countries/Tatar.txt"
KHR = "countries/Khereid.txt"
NAI = "countries/Naiman.txt"
MEK = "countries/Merkit.txt"
ONG = "countries/Ongud.txt"
JLI = "countries/Jalair.txt"
BRL = "countries/Barlas.txt"

#Far Eastern
SNG = "countries/Song.txt"
XIX = "countries/Xixia.txt"
KMK = "countries/Kamakura.txt"
LIA = "countries/Liao.txt"
GSG = "countries/GreatSong.txt"
GJN = "countries/GreatJin.txt"
GYO = "countries/Goryeo.txt"


#India and Burma
BAG = "countries/Pagan.txt"
YDV = "countries/Seuna.txt"
CHN = "countries/Chandela.txt"
KKY = "countries/Kakatiya.txt"
CDI = "countries/Chedi.txt"
CTI = "countries/Chitradurga.txt"
COA = "countries/Chola.txt"
KPR = "countries/Kolhapur.txt"
KMR = "countries/Kamarupa.txt"
KHS = "countries/Khasa.txt"
HSL = "countries/Hoysala.txt"

#East Indies
SRI = "countries/Srivijaya.txt"
PAH = "countries/Pahang.txt"
SIN = "countries/Singhasari.txt"
GAU = "countries/Galuh.txt"
KEI = "countries/Kediri.txt"

